[Yellow,
19.07.18,
15:04, 10,
10, 2, testmap,
map.png, ~]



#
55555555555555555555
55555555555555556955
55555555555500000055
55555555555555550055
55555555555555550055
55555555555555550055
55555555555555550055
55555555555555550055
55555555555555550055
55555555555555555555


~
00000000000000000000
00000000000000000000
00000000000001010100
00000000000000000100
00000000000000000100
00000000000000000100
00000000000000000100
00000000000000000100
00000000000000000100
00000000000000000000

|1|8|./../maps/testmap2|
