[Yellow,
19.07.18,
15:04, 10,
60, 2, testmap,
map.png, ~]



#
01010101010101010101
01010101010101016901
01010101010101010101
01010101010101010101
01010101010101010101
01010101010101010101
01010101010101010101
01010101010101010101
01010101010101010101
01010101010101010101
01010101010101010101
01010101010101010101
01010101010101010101
01010101010101010101
01010101010101010101
01010101010101010101
01010101010101010101
01010101010101010101
01010101010101010101
01010101010101010101
01010101010101010101
01010101010101010101
01010101010101010101
01010101010101010101
01010101010101010101
01010101010101010101
01010101010101010101
01010101010101010101
01010101010101010101
01010101010101010101
01010101010101010101
01010101010101010101
01010101010101010101
01010101010101010101
01010101010101010101
01010101010101010101
01010101010101010101
01010101010101010101
01010101010101010101
01010101010101010101
01010101010101010101
01010101010101010101
01010101010101010101
01010101010101010101
01010101010101010101
01010101010101010101
01010101010101010101
01010101010101010101
01010101010101010101
01010101010101010101
01010101010101010101
01010101010101010101
01010101010101010101
01010101010101010101
01010101010101010101
01010101010101010101
01010101010101010101
01010101010101010101
01010101010101010101
01010101010101010101

~
00000000000000000000
00000000000000000000
00000000000000000000
00000000000000000000
00000000000000000000
00000000000000000000
00000000000000000000
00000000000000000000
00000000000000000000
00000000000000000000
00000000000000000000
00000000000000000000
00000000000000000000
00000000000000000000
00000000000000000000
00000000000000000000
00000000000000000000
00000000000000000000
00000000000000000000
00000000000000000000
00000000000000000000
00000000000000000000
00000000000000000000
00000000000000000000
00000000000000000000
00000000000000000000
00000000000000000000
00000000000000000000
00000000000000000000
00000000000000000000
00000000000000000000
00000000000000000000
00000000000000000000
00000000000000000000
00000000000000000000
00000000000000000000
00000000000000000000
00000000000000000000
00000000000000000000
00000000000000000000
00000000000000000000
00000000000000000000
00000000000000000000
00000000000000000000
00000000000000000000
00000000000000000000
00000000000000000000
00000000000000000000
00000000000000000000
00000000000000000000
00000000000000000000
00000000000000000000
00000000000000000000
00000000000000000000
00000000000000000000
00000000000000000000
00000000000000000000
00000000000000000000
00000000000000000000
00000000000000000000

|1|8|./maps/cave|
