[Yellow,
19.07.18,
15:04, 10,
60, 2, testmap,
map.png, ~]



#
00010203040506070809
10111213141516171819
20212223242526272829
30313233343536373839
40414243444546474849
00010203040506070809
10111213141516171819
20212223242526272829
30313233343536373839
40414243444546474849
00010203040506070809
10111213141516171819
20212223242526272829
30313233343536373839
40414243444546474849
00010203040506070809
10111213141516171819
20212223242526272829
30313233343536373839
40414243444546474849
00010203040506070809
10111213141516171819
20212223242526272829
30313233343536373839
40414243444546474849
00010203040506070809
10111213141516171819
20212223242526272829
30313233343536373839
40414243444546474849
00010203040506070809
10111213141516171819
20212223242526272829
30313233343536373839
40414243444546474849
00010203040506070809
10111213141516171819
20212223242526272829
30313233343536373839
40414243444546474849
00010203040506070809
10111213141516171819
20212223242526272829
30313233343536373839
40414243444546474849
00010203040506070809
10111213141516171819
20212223242526272829
30313233343536373839
40414243444546474849
00010203040506070809
10111213141516171819
20212223242526272829
30313233343536373839
40414243444546474849
00010203040506070809
10111213141516171819
20212223242526272829
30313233343536373839
40414243444546474849

~
